[
["CIE", "1"],
["ICR", "2"],
["ICE", "3"],
["ECI", "4"],
["EIC", "4"],
["CIR", "5"]
]
