[
["1", "CIE"],
["2", "ICR"],
["3", "ICE"],
["4", "ECI"],
["5", "EIC"],
["6", "CIR"]
]
