[
["1", "R"],
["2", "I"],
["3", "A"],
["4", "S"],
["5", "E"],
["6", "C"]
]
